#####
#.e.#
#.#.#
#...#
#####
##x##
#####