########
#..#..##
#.####.#
#.#x.e.#
#.####.#
#......#
########