..#############################
........#.......#.....#.#.....#
###.#.#.#.#.###.#.###.#.###.#.#
#...#.#.#.#...#.#.#.#...#...#.#
#.###.#####.###.###.###.###.###
#...#.......#...#.......#.....#
###########e###.#.#######.#####
#...#...#.....#.....#.........#
#.#####.#.#.###########.#.#####
#...#.#.#.#.....#.#.#.#.#.....#
#.#.#.#.#.###.###.#.#.#.###.###
#.#.......#.#...#.........#...#
###.#######.###.###.#######.#.#
#.#.....#.#.#.......#.#.#...#.#
#.#.#.#.#.#.#.#####.#.#.###.#.#
#.#.#.#...#.#.....#...#.....#.#
#.#####.#.#.###########.#.###.#
#.....#.#...........#.#.#.#.#.#
#.#######.#########.#.#####.#.#
#.#.#.......#.....#.#.#.......#
#.#.#.#.#######.###.#.###.#####
#.....#.........#.......#.#...#
#####.###.#############.###.#.#
#.#.....#...#.#.#.......#...#.#
#.#.#######.#.#.#.#.#.#####.#.#
#.........#.....#.#.#.#.....#.#
#.#.###.###############.###.#.#
#.#.#...#.......#.......#.#.#.#
###.###.#.###.###.###.#.#.#####
#.....#...#...#...#...#.#.....#
#.###########.#.###.#.#.###.###
#.#.........#.#...#.#.#.#.....#
#.#.#####.###########.###.#.###
#.......#.....#.#.......#.#.#.#
#####.#.#######.#######.#.###.#
#.#...#.........#.....#.#.....#
#.#.###.###.#.#####.###.#####.#
#.#...#...#.#...#.............#
#.#.#####.#.###.#.#.#.#.###.###
#.....#...#.#.....#.#.#.#.....#
#############################.x