##############
###........###
###.##########
###.##......##
###.##.#######
x.e.#.......##
###.#.#.######
###.#.......##
###.#.########
###.........##
##############
