e.#############################
..#...#.......#.....#...#.....#
#.#.#####.#.#.###.###.#.#.#.#.#
#...#.#...#.#.........#...#.#.#
#.###.#.#####.#.#.#.#.#.#.#####
#.......#.#.#.#.#.#.#.#.#.....#
#########.#.#.###########.###.#
#.............#.#.....#...#...#
#.###.#####.###.#####.#.###.#.#
#.#.......#.....#.....#...#.#.#
###############.#.#.#.#####.#.#
#.....#.........#.#.#...#.#.#.#
#####.#######.#######.#.#.###.#
#...#.......#...#.....#...#.#.#
#.#####.###.#####.#######.#.#.#
#.....#.#...........#.......#.#
#.###.#####.#.#############.#.#
#.#.......#.#.#.....#.#.#.....#
#####.###.#.#####.###.#.#####.#
#.......#...............#.....#
#x###########################.#