..#############################
......#.#.#...#.....#.#...#...x
#####.#.#.###e#.#.###.###.#.###
#.....#.#.#...#.#.....#.....#.#
#.###.#.#.###.###.###.###.#.#.#
#.#.....#.....#...#.#.....#...#
#.###.#.#####.#####.#.#####.###
#.#.#.#...#.....#.........#...#
#.#.#####.#.#####.#####.#######
#.#.#.#.#...#.....#.#.#...#...#
###.#.#.#.###.#####.#.#####.#.#
#.#.....#...#.#...#.......#.#.#
#.###.#####.#.#.#####.#####.#.#
#...#.......#.....#.#.#.#...#.#
#.#.#####.#.#.#####.#.#.#.#.#.#
#.#.#...#.#.#.#...#.......#.#.#
#.#.###.#.#.#.###.###.#.###.#.#
#.#.#.....#...#...#.#.#...#.#.#
#.#.#.#####.###.#.#.###.#####.#
#.#.....#.......#.......#.....#
#############################.#